AVA	EY V AH
BACKPACK	B AE K P AE K
BETTER	B EH T ER
CAN	K AE N
CAN(2)	K AH N
FAVORITE	F EY V ER IH T
FAVORITE(2)	F EY V R AH T
FEELING	F IY L IH NG
GO	G OW
GOOD	G UH D
GOOD(2)	G IH D
HEY	HH EY
HI	HH AY
HOME	HH OW M
I	AY
Iâ€™M	IH M
MORNING	M AO R N IH NG
MY	M AY
NIGHT	N AY T
NO	N OW
OKAY	OW K EY
PLAY	P L EY
SAD	S AE D
SEE	S IY
SONG	S AO NG
STRESSED	S T R EH S T
THANKS	TH AE NG K S
YES	Y EH S
YOU	Y UW
YOUR	Y AO R
YOUR(2)	Y UH R
