AVA	EY V AH
BACKPACK	B AE K P AE K
DONE	D AH N
FAVORITE	F EY V ER IH T
FAVORITE(2)	F EY V R AH T
FEELING	F IY L IH NG
GOOD	G UH D
GOOD(2)	G IH D
I'M	AY M
I'M(2)	AH M
MORNING	M AO R N IH NG
MY	M AY
NIGHT	N AY T
NO	N OW
NOT	N AA T
OKAY	OW K EY
PLAY	P L EY
PLEASE	P L IY Z
REALLY	R IH L IY
REALLY(2)	R IY L IY
SAD	S AE D
SONG	S AO NG
STRESSED	S T R EH S T
THANK	TH AE NG K
THANKS	TH AE NG K S
YES	Y EH S
YOU	Y UW
YOUR	Y AO R
YOUR(2)	Y UH R
